1231231231
1   3    2
2   2  3 2
3      2 2
1   1  121
11 23    3
1     1  1
3  1  23 1
1  3   1 4
1231231231