1231231231
1    1   2
1    2   1
2  1131  2
3        1
1123  2  3
1    1  31
3 1    121
1 2  1   4
1231231231